-----------------------------------------------------------------------------------------
----------------------------------D-------------------------------------------*----------
<<<<<<-------------------*----------X------------------*---------------------------->>>>-
--------------------[--------]--------------^---------[-------]------[--------]----------
-----------------------^-----------------[-------]---------------------------------------