-----------------------------------------------------------------------------------------
----------------------------------D-------------------------------------------*----------
<<<<<<-------------------*----------X------------------*----------L----------------->>>>-
--------------------[--------]--------------^---------[-------]------[--------]----------
-----------------------^-----------------[-------]---------------------------------------