----------------------------------------------------------------------------------------------------------------------------------------------------------------
----------------------------------D-----------------------------X----*-------------------------------------------------------------------------------*----------
<<<<<<-------------------X--------------------*--------------------%-------------------------L--------------------------------------------------*---------->>>>-
---------------[--------]----------------X--------[--------]--------^----------------------[--------]-------[-------]----X------------[--------]----------------
------------------------------[-------]------------^----^-----------------^--[--------]---------------------------------[-------]-------------------------------
-----------------------------------------------------------------------------^---^---^-------------------------------------------------------------------------- 